POS,PLAYER,GP,G,A,P,PIM,+/-
LW,J.Benn,59,34,35,69,22,11
RW,P.Laine,60,21,42,63,18,9
C,C.Giroux,58,23,36,59,8,-5
C,T.Seguin,59,24,35,59,10,10
C,S.Crosby,57,17,41,58,36,6
C,A.Kopitar,54,24,31,55,20,15
C,B.Dubinsky,57,18,37,55,42,19
RW,G.Nyquist,58,20,34,54,6,8
RW,V.Tarasenko,58,29,25,54,8,-2
RW,P.Kessel,57,24,30,54,10,5
LW,A.Ovechkin,51,41,12,53,32,22
LW,M.Pacioretty,58,25,28,53,20,15
C,N.Backstrom,56,10,43,53,6,24